images/rocks_40x40_transparent.png
39 39 10 4 1 22
11 3 3 3 3 3 3 3 3 3 3 3 3 3 3 3 3 3 3 3 3 15
0  0 0 0 0 0 0 0 0 0 0 0 0 0 0 0 0 0 0 0 0 0
0  0 0 0 0 0 0 0 0 3 0 0 0 0 0 0 0 0 0 0 0 0
0  0 0 0 0 0 0 0 0 3 0 0 0 0 0 0 0 0 0 0 0 0
0  0 0 0 0 0 0 0 0 3 0 0 0 0 0 0 0 0 0 0 0 0
0  0 0 0 0 0 0 0 0 3 0 0 0 0 0 0 0 0 0 0 0 0
0  0 0 0 0 0 0 0 0 3 0 0 0 0 0 0 0 0 0 0 0 0
0  0 0 0 0 0 0 0 0 3 0 0 0 0 0 0 0 0 0 0 0 0
0  0 0 0 0 0 0 0 0 3 0 0 0 0 0 0 0 0 0 0 0 0
0  0 0 0 0 0 0 0 0 3 0 0 0 0 0 0 0 0 0 0 0 0
0  0 0 0 0 0 0 0 0 3 0 0 0 0 0 0 0 0 0 0 0 0
0  0 0 0 0 0 0 0 0 0 0 0 0 0 0 0 0 0 0 0 0 0
0  19 20 0 0 0 0 0 0 0 0 0 0 0 0 0 0 0 0 0 0 0
11 3 3 3 3 3 3 3 3 3 3 3 3 3 3 3 3 3 3 3 3 15
