images/rocks_40x40_transparent.png
40 40 10 4 0 22
0  0 0 0 3 3 3 3 3 3 3 3 3 3 3 3 3 3 3 3 3 15
0  0 0 0 0 0 0 0 0 0 0 0 0 0 0 0 0 0 0 0 0 0
0  0 0 0 0 0 0 0 0 0 0 0 0 0 0 0 0 0 0 0 0 0
0  0 0 0 0 0 0 0 0 0 3 0 0 0 0 0 0 0 0 0 0 0
0  0 0 0 0 0 0 0 0 0 3 0 0 0 0 0 0 0 0 0 0 0
0  0 0 0 0 0 0 0 0 0 3 0 0 0 0 0 0 0 0 0 0 0
0  0 0 0 0 0 0 0 0 0 3 0 0 0 0 0 0 0 0 0 0 0
0  0 0 0 0 0 0 0 0 0 3 0 0 0 0 0 0 0 0 0 0 0
0  0 0 0 0 0 0 0 0 0 3 0 0 0 0 0 0 0 0 0 0 0
0  0 0 0 0 0 0 0 0 0 3 0 0 0 0 0 0 0 0 0 0 0
0  0 0 0 0 0 0 0 0 0 3 0 0 0 0 0 0 0 0 0 0 0
0  0 0 0 0 0 0 0 0 0 0 0 0 0 0 0 0 0 0 0 0 0
0  19 20 0 0 0 0 0 0 0 0 0 0 0 0 0 0 0 0 0 0 0
11 3 3 3 3 3 3 3 3 3 3 3 3 3 3 3 3 3 3 3 3 15
