images/rocks.png
40 40 10 4 0 440
3  3  3  3 3 3 3 3 3 3 3 3 3 3 3 3 3 3 3 3 3 3 3  3  3  3 3 3 3 3 3 3 3 3 3 3 3 3 3 3 3 3 3 3 3  3  3  3 3 3 3 3 3 3 3 3 3 3 3 3 3 3 3 3 3 3 3  3  3  3 3 3 3 3 3 3 3 3 3 3 3 3 3 3 3 3 3 3 3  3  3  3 3 3 3 3 3 3 3 3 3 3 3 3 3 3 3 3 3 3 3  3  3  3 3 3 3 3 3 3 3 3 3 3 3 3 3 3 3 3 3 3 3  3  3  3 3 3 3 3 3 3 3 3 3 3 3 3 3 3 3 3 3 3 3  3  3  3 3 3 3 3 3 3 3 3 3 3 3 3 3 3 3 3 3 3 3  3  3  3 3 3 3 3 3 3 3 3 3 3 3 3 3 3 3 3 3 3 3  3  3  3 3 3 3 3 3 3 3 3 3 3 3 3 3 3 3 3 3 3 0  0  0  0 3 3 3 3 3 3 3 3 3 3 3 3 3 3 3 3 3 3 3  3  3  3 3 3 3 3 3 3 3 3 3 3 3 3 3 3 3 3 3 3 3  3  3  3 3 3 3 3 3 3 3 3 3 3 3 3 3 3 3 3 3 3 3  3  3  3 3 3 3 3 3 3 3 3 3 3 3 3 3 3 3 3 3 3 3  3  3  3 3 3 3 3 3 3 3 3 3 3 3 3 3 3 3 3 3 3 3  3  3  3 3 3 3 3 3 3 3 3 3 3 3 3 3 3 3 3 3 3 3  3  3  3 3 3 3 3 3 3 3 3 3 3 3 3 3 3 3 3 3 3 3  3  3  3 3 3 3 3 3 3 3 3 3 3 3 3 3 3 3 3 3 3 3  3  3  3 3 3 3 3 3 3 3 3 3 3 3 3 3 3 3 3 3 3 3  3  3  3 3 3 3 3 3 3 3 3 3 3 3 3 3 3 3 3 3 3
0  0  0  0 0 0 0 0 0 0 0 0 0 0 0 0 0 0 0 0 0 0 0  0  0  0 0 0 0 0 0 0 0 0 0 0 0 0 0 0 0 0 0 0 0  0  0  0 0 0 0 0 0 0 0 0 0 0 0 0 0 0 0 0 0 0 0  0  0  0 0 0 0 0 0 0 0 0 0 0 0 0 0 0 0 0 0 0 0  0  0  0 0 0 0 0 0 0 0 0 0 0 0 0 0 0 0 0 0 0 0  0  0  0 0 0 0 0 0 0 0 0 0 0 0 0 0 0 0 0 0 0 0  0  0  0 0 0 0 0 0 0 0 0 0 0 0 0 0 0 0 0 0 0 0  0  0  0 0 0 0 0 0 0 0 0 0 0 0 0 0 0 0 0 0 0 0  0  0  0 0 0 0 0 0 0 0 0 0 0 0 0 0 0 0 0 0 0 0  0  0  0 0 0 0 0 0 0 0 0 0 0 0 0 0 0 0 0 0 0 0  0  0  0 0 0 0 0 0 0 0 0 0 0 0 0 0 0 0 0 0 0 0  0  0  0 0 0 0 0 0 0 0 0 0 0 0 0 0 0 0 0 0 0 0  0  0  0 0 0 0 0 0 0 0 0 0 0 0 0 0 0 0 0 0 0 0  0  0  0 0 0 0 0 0 0 0 0 0 0 0 0 0 0 0 0 0 0 0  0  0  0 0 0 0 0 0 0 0 0 0 0 0 0 0 0 0 0 0 0 0  0  0  0 0 0 0 0 0 0 0 0 0 0 0 0 0 0 0 0 0 0 0  0  0  0 0 0 0 0 0 0 0 0 0 0 0 0 0 0 0 0 0 0 0  0  0  0 0 0 0 0 0 0 0 0 0 0 0 0 0 0 0 0 0 0 0  0  0  0 0 0 0 0 0 0 0 0 0 0 0 0 0 0 0 0 0 0 0  0  0  0 0 0 0 0 0 0 0 0 0 0 0 0 0 0 0 0 0 0
0  0  0  0 0 0 0 0 0 0 0 0 0 0 0 0 0 0 0 0 0 0 0  0  0  0 0 0 0 0 0 0 0 0 0 0 0 0 0 0 0 0 0 0 0  0  0  0 0 0 0 0 0 0 0 0 0 0 0 0 0 0 0 0 0 0 0  0  0  0 0 0 0 0 0 0 0 0 0 0 0 0 0 0 0 0 0 0 0  0  0  0 0 0 0 0 0 0 0 0 0 0 0 0 0 0 0 0 0 0 0  0  0  0 0 0 0 0 0 0 0 0 0 0 0 0 0 0 0 0 0 0 0  0  0  0 0 0 0 0 0 0 0 0 0 0 0 0 0 0 0 0 0 0 0  0  0  0 0 0 0 0 0 0 0 0 0 0 0 0 0 0 0 0 0 0 0  0  0  0 0 0 0 0 0 0 0 0 0 0 0 0 0 0 0 0 0 0 0  0  0  0 0 0 0 0 0 0 0 0 0 0 0 0 0 0 0 0 0 0 0  0  0  0 0 0 0 0 0 0 0 0 0 0 0 0 0 0 0 0 0 0 0  0  0  0 0 0 0 0 0 0 0 0 0 0 0 0 0 0 0 0 0 0 0  0  0  0 0 0 0 0 0 0 0 0 0 0 0 0 0 0 0 0 0 0 0  0  0  0 0 0 0 0 0 0 0 0 0 0 0 0 0 0 0 0 0 0 0  0  0  0 0 0 0 0 0 0 0 0 0 0 0 0 0 0 0 0 0 0 0  0  0  0 0 0 0 0 0 0 0 0 0 0 0 0 0 0 0 0 0 0 0  0  0  0 0 0 0 0 0 0 0 0 0 0 0 0 0 0 0 0 0 0 0  0  0  0 0 0 0 0 0 0 0 0 0 0 0 0 0 0 0 0 0 0 0  0  0  0 0 0 0 0 0 0 0 0 0 0 0 0 0 0 0 0 0 0 0  0  0  0 0 0 0 0 0 0 0 0 0 0 0 0 0 0 0 0 0 0
0  0  0  0 0 0 0 0 0 0 3 0 0 0 0 0 0 0 0 0 0 0 0  0  0  0 0 0 0 0 0 0 3 0 0 0 0 0 0 0 0 0 0 0 0  0  0  0 0 0 0 0 0 0 3 0 0 0 0 0 0 0 0 0 0 0 0  0  0  0 0 0 0 0 0 0 3 0 0 0 0 0 0 0 0 0 0 0 0  0  0  0 0 0 0 0 0 0 3 0 0 0 0 0 0 0 0 0 0 0 0  0  0  0 0 0 0 0 0 0 3 0 0 0 0 0 0 0 0 0 0 0 0  0  0  0 0 0 0 0 0 0 3 0 0 0 0 0 0 0 0 0 0 0 0  0  0  0 0 0 0 0 0 0 3 0 0 0 0 0 0 0 0 0 0 0 0  0  0  0 0 0 0 0 0 0 3 0 0 0 0 0 0 0 0 0 0 0 0  0  0  0 0 0 0 0 0 0 3 0 0 0 0 0 0 0 0 0 0 0 0  0  0  0 0 0 0 0 0 0 3 0 0 0 0 0 0 0 0 0 0 0 0  0  0  0 0 0 0 0 0 0 3 0 0 0 0 0 0 0 0 0 0 0 0  0  0  0 0 0 0 0 0 0 3 0 0 0 0 0 0 0 0 0 0 0 0  0  0  0 0 0 0 0 0 0 3 0 0 0 0 0 0 0 0 0 0 0 0  0  0  0 0 0 0 0 0 0 3 0 0 0 0 0 0 0 0 0 0 0 0  0  0  0 0 0 0 0 0 0 3 0 0 0 0 0 0 0 0 0 0 0 0  0  0  0 0 0 0 0 0 0 3 0 0 0 0 0 0 0 0 0 0 0 0  0  0  0 0 0 0 0 0 0 3 0 0 0 0 0 0 0 0 0 0 0 0  0  0  0 0 0 0 0 0 0 3 0 0 0 0 0 0 0 0 0 0 0 0  0  0  0 0 0 0 0 0 0 3 0 0 0 0 0 0 0 0 0 0 0
0  0  0  0 0 0 0 0 0 0 3 0 0 0 0 0 0 0 0 0 0 0 0  0  0  0 0 0 0 0 0 0 3 0 0 0 0 0 0 0 0 0 0 0 0  0  0  0 0 0 0 0 0 0 3 0 0 0 0 0 0 0 0 0 0 0 0  0  0  0 0 0 0 0 0 0 3 0 0 0 0 0 0 0 0 0 0 0 0  0  0  0 0 0 0 0 0 0 3 0 0 0 0 0 0 0 0 0 0 0 0  0  0  0 0 0 0 0 0 0 3 0 0 0 0 0 0 0 0 0 0 0 0  0  0  0 0 0 0 0 0 0 3 0 0 0 0 0 0 0 0 0 0 0 0  0  0  0 0 0 0 0 0 0 3 0 0 0 0 0 0 0 0 0 0 0 0  0  0  0 0 0 0 0 0 0 3 0 0 0 0 0 0 0 0 0 0 0 0  0  0  0 0 0 0 0 0 0 3 0 0 0 0 0 0 0 0 0 0 0 0  0  0  0 0 0 0 0 0 0 3 0 0 0 0 0 0 0 0 0 0 0 0  0  0  0 0 0 0 0 0 0 3 0 0 0 0 0 0 0 0 0 0 0 0  0  0  0 0 0 0 0 0 0 3 0 0 0 0 0 0 0 0 0 0 0 0  0  0  0 0 0 0 0 0 0 3 0 0 0 0 0 0 0 0 0 0 0 0  0  0  0 0 0 0 0 0 0 3 0 0 0 0 0 0 0 0 0 0 0 0  0  0  0 0 0 0 0 0 0 3 0 0 0 0 0 0 0 0 0 0 0 0  0  0  0 0 0 0 0 0 0 3 0 0 0 0 0 0 0 0 0 0 0 0  0  0  0 0 0 0 0 0 0 3 0 0 0 0 0 0 0 0 0 0 0 0  0  0  0 0 0 0 0 0 0 3 0 0 0 0 0 0 0 0 0 0 0 0  0  0  0 0 0 0 0 0 0 3 0 0 0 0 0 0 0 0 0 0 0
0  0  0  0 0 0 0 0 0 0 3 0 0 0 0 0 0 0 0 0 0 0 0  0  0  0 0 0 0 0 0 0 3 0 0 0 0 0 0 0 0 0 0 0 0  0  0  0 0 0 0 0 0 0 3 0 0 0 0 0 0 0 0 0 0 0 0  0  0  0 0 0 0 0 0 0 3 0 0 0 0 0 0 0 0 0 0 0 0  0  0  0 0 0 0 0 0 0 3 0 0 0 0 0 0 0 0 0 0 0 0  0  0  0 0 0 0 0 0 0 3 0 0 0 0 0 0 0 0 0 0 0 0  0  0  0 0 0 0 0 0 0 3 0 0 0 0 0 0 0 0 0 0 0 0  0  0  0 0 0 0 0 0 0 3 0 0 0 0 0 0 0 0 0 0 0 0  0  0  0 0 0 0 0 0 0 3 0 0 0 0 0 0 0 0 0 0 0 0  0  0  0 0 0 0 0 0 0 3 0 0 0 0 0 0 0 0 0 0 0 0  0  0  0 0 0 0 0 0 0 3 0 0 0 0 0 0 0 0 0 0 0 0  0  0  0 0 0 0 0 0 0 3 0 0 0 0 0 0 0 0 0 0 0 0  0  0  0 0 0 0 0 0 0 3 0 0 0 0 0 0 0 0 0 0 0 0  0  0  0 0 0 0 0 0 0 3 0 0 0 0 0 0 0 0 0 0 0 0  0  0  0 0 0 0 0 0 0 3 0 0 0 0 0 0 0 0 0 0 0 0  0  0  0 0 0 0 0 0 0 3 0 0 0 0 0 0 0 0 0 0 0 0  0  0  0 0 0 0 0 0 0 3 0 0 0 0 0 0 0 0 0 0 0 0  0  0  0 0 0 0 0 0 0 3 0 0 0 0 0 0 0 0 0 0 0 0  0  0  0 0 0 0 0 0 0 3 0 0 0 0 0 0 0 0 0 0 0 0  0  0  0 0 0 0 0 0 0 3 0 0 0 0 0 0 0 0 0 0 0
0  0  0  0 0 0 0 0 0 0 3 0 0 0 0 0 0 0 0 0 0 0 0  0  0  0 0 0 0 0 0 0 3 0 0 0 0 0 0 0 0 0 0 0 0  0  0  0 0 0 0 0 0 0 3 0 0 0 0 0 0 0 0 0 0 0 0  0  0  0 0 0 0 0 0 0 3 0 0 0 0 0 0 0 0 0 0 0 0  0  0  0 0 0 0 0 0 0 3 0 0 0 0 0 0 0 0 0 0 0 0  0  0  0 0 0 0 0 0 0 3 0 0 0 0 0 0 0 0 0 0 0 0  0  0  0 0 0 0 0 0 0 3 0 0 0 0 0 0 0 0 0 0 0 0  0  0  0 0 0 0 0 0 0 3 0 0 0 0 0 0 0 0 0 0 0 0  0  0  0 0 0 0 0 0 0 3 0 0 0 0 0 0 0 0 0 0 0 0  0  0  0 0 0 0 0 0 0 3 0 0 0 0 0 0 0 0 0 0 0 0  0  0  0 0 0 0 0 0 0 3 0 0 0 0 0 0 0 0 0 0 0 0  0  0  0 0 0 0 0 0 0 3 0 0 0 0 0 0 0 0 0 0 0 0  0  0  0 0 0 0 0 0 0 3 0 0 0 0 0 0 0 0 0 0 0 0  0  0  0 0 0 0 0 0 0 3 0 0 0 0 0 0 0 0 0 0 0 0  0  0  0 0 0 0 0 0 0 3 0 0 0 0 0 0 0 0 0 0 0 0  0  0  0 0 0 0 0 0 0 3 0 0 0 0 0 0 0 0 0 0 0 0  0  0  0 0 0 0 0 0 0 3 0 0 0 0 0 0 0 0 0 0 0 0  0  0  0 0 0 0 0 0 0 3 0 0 0 0 0 0 0 0 0 0 0 0  0  0  0 0 0 0 0 0 0 3 0 0 0 0 0 0 0 0 0 0 0 0  0  0  0 0 0 0 0 0 0 3 0 0 0 0 0 0 0 0 0 0 0
0  0  0  0 0 0 0 0 0 0 3 0 0 0 0 0 0 0 0 0 0 0 0  0  0  0 0 0 0 0 0 0 3 0 0 0 0 0 0 0 0 0 0 0 0  0  0  0 0 0 0 0 0 0 3 0 0 0 0 0 0 0 0 0 0 0 0  0  0  0 0 0 0 0 0 0 3 0 0 0 0 0 0 0 0 0 0 0 0  0  0  0 0 0 0 0 0 0 3 0 0 0 0 0 0 0 0 0 0 0 0  0  0  0 0 0 0 0 0 0 3 0 0 0 0 0 0 0 0 0 0 0 0  0  0  0 0 0 0 0 0 0 3 0 0 0 0 0 0 0 0 0 0 0 0  0  0  0 0 0 0 0 0 0 3 0 0 0 0 0 0 0 0 0 0 0 0  0  0  0 0 0 0 0 0 0 3 0 0 0 0 0 0 0 0 0 0 0 0  0  0  0 0 0 0 0 0 0 3 0 0 0 0 0 0 0 0 0 0 0 0  0  0  0 0 0 0 0 0 0 3 0 0 0 0 0 0 0 0 0 0 0 0  0  0  0 0 0 0 0 0 0 3 0 0 0 0 0 0 0 0 0 0 0 0  0  0  0 0 0 0 0 0 0 3 0 0 0 0 0 0 0 0 0 0 0 0  0  0  0 0 0 0 0 0 0 3 0 0 0 0 0 0 0 0 0 0 0 0  0  0  0 0 0 0 0 0 0 3 0 0 0 0 0 0 0 0 0 0 0 0  0  0  0 0 0 0 0 0 0 3 0 0 0 0 0 0 0 0 0 0 0 0  0  0  0 0 0 0 0 0 0 3 0 0 0 0 0 0 0 0 0 0 0 0  0  0  0 0 0 0 0 0 0 3 0 0 0 0 0 0 0 0 0 0 0 0  0  0  0 0 0 0 0 0 0 3 0 0 0 0 0 0 0 0 0 0 0 0  0  0  0 0 0 0 0 0 0 3 0 0 0 0 0 0 0 0 0 0 0
0  0  0  0 0 0 0 0 0 0 3 0 0 0 0 0 0 0 0 0 0 0 0  0  0  0 0 0 0 0 0 0 3 0 0 0 0 0 0 0 0 0 0 0 0  0  0  0 0 0 0 0 0 0 3 0 0 0 0 0 0 0 0 0 0 0 0  0  0  0 0 0 0 0 0 0 3 0 0 0 0 0 0 0 0 0 0 0 0  0  0  0 0 0 0 0 0 0 3 0 0 0 0 0 0 0 0 0 0 0 0  0  0  0 0 0 0 0 0 0 3 0 0 0 0 0 0 0 0 0 0 0 0  0  0  0 0 0 0 0 0 0 3 0 0 0 0 0 0 0 0 0 0 0 0  0  0  0 0 0 0 0 0 0 3 0 0 0 0 0 0 0 0 0 0 0 0  0  0  0 0 0 0 0 0 0 3 0 0 0 0 0 0 0 0 0 0 0 0  0  0  0 0 0 0 0 0 0 3 0 0 0 0 0 0 0 0 0 0 0 0  0  0  0 0 0 0 0 0 0 3 0 0 0 0 0 0 0 0 0 0 0 0  0  0  0 0 0 0 0 0 0 3 0 0 0 0 0 0 0 0 0 0 0 0  0  0  0 0 0 0 0 0 0 3 0 0 0 0 0 0 0 0 0 0 0 0  0  0  0 0 0 0 0 0 0 3 0 0 0 0 0 0 0 0 0 0 0 0  0  0  0 0 0 0 0 0 0 3 0 0 0 0 0 0 0 0 0 0 0 0  0  0  0 0 0 0 0 0 0 3 0 0 0 0 0 0 0 0 0 0 0 0  0  0  0 0 0 0 0 0 0 3 0 0 0 0 0 0 0 0 0 0 0 0  0  0  0 0 0 0 0 0 0 3 0 0 0 0 0 0 0 0 0 0 0 0  0  0  0 0 0 0 0 0 0 3 0 0 0 0 0 0 0 0 0 0 0 0  0  0  0 0 0 0 0 0 0 3 0 0 0 0 0 0 0 0 0 0 0
0  0  0  0 0 0 0 0 0 0 3 0 0 0 0 0 0 0 0 0 0 0 0  0  0  0 0 0 0 0 0 0 3 0 0 0 0 0 0 0 0 0 0 0 0  0  0  0 0 0 0 0 0 0 3 0 0 0 0 0 0 0 0 0 0 0 0  0  0  0 0 0 0 0 0 0 3 0 0 0 0 0 0 0 0 0 0 0 0  0  0  0 0 0 0 0 0 0 3 0 0 0 0 0 0 0 0 0 0 0 0  0  0  0 0 0 0 0 0 0 3 0 0 0 0 0 0 0 0 0 0 0 0  0  0  0 0 0 0 0 0 0 3 0 0 0 0 0 0 0 0 0 0 0 0  0  0  0 0 0 0 0 0 0 3 0 0 0 0 0 0 0 0 0 0 0 0  0  0  0 0 0 0 0 0 0 3 0 0 0 0 0 0 0 0 0 0 0 0  0  0  0 0 0 0 0 0 0 3 0 0 0 0 0 0 0 0 0 0 0 0  0  0  0 0 0 0 0 0 0 3 0 0 0 0 0 0 0 0 0 0 0 0  0  0  0 0 0 0 0 0 0 3 0 0 0 0 0 0 0 0 0 0 0 0  0  0  0 0 0 0 0 0 0 3 0 0 0 0 0 0 0 0 0 0 0 0  0  0  0 0 0 0 0 0 0 3 0 0 0 0 0 0 0 0 0 0 0 0  0  0  0 0 0 0 0 0 0 3 0 0 0 0 0 0 0 0 0 0 0 0  0  0  0 0 0 0 0 0 0 3 0 0 0 0 0 0 0 0 0 0 0 0  0  0  0 0 0 0 0 0 0 3 0 0 0 0 0 0 0 0 0 0 0 0  0  0  0 0 0 0 0 0 0 3 0 0 0 0 0 0 0 0 0 0 0 0  0  0  0 0 0 0 0 0 0 3 0 0 0 0 0 0 0 0 0 0 0 0  0  0  0 0 0 0 0 0 0 3 0 0 0 0 0 0 0 0 0 0 0
0  0  0  0 0 0 0 0 0 0 3 0 0 0 0 0 0 0 0 0 0 0 0  0  0  0 0 0 0 0 0 0 3 0 0 0 0 0 0 0 0 0 0 0 0  0  0  0 0 0 0 0 0 0 3 0 0 0 0 0 0 0 0 0 0 0 0  0  0  0 0 0 0 0 0 0 3 0 0 0 0 0 0 0 0 0 0 0 0  0  0  0 0 0 0 0 0 0 3 0 0 0 0 0 0 0 0 0 0 0 0  0  0  0 0 0 0 0 0 0 3 0 0 0 0 0 0 0 0 0 0 0 0  0  0  0 0 0 0 0 0 0 3 0 0 0 0 0 0 0 0 0 0 0 0  0  0  0 0 0 0 0 0 0 3 0 0 0 0 0 0 0 0 0 0 0 0  0  0  0 0 0 0 0 0 0 3 0 0 0 0 0 0 0 0 0 0 0 0  0  0  0 0 0 0 0 0 0 3 0 0 0 0 0 0 0 0 0 0 0 0  0  0  0 0 0 0 0 0 0 3 0 0 0 0 0 0 0 0 0 0 0 0  0  0  0 0 0 0 0 0 0 3 0 0 0 0 0 0 0 0 0 0 0 0  0  0  0 0 0 0 0 0 0 3 0 0 0 0 0 0 0 0 0 0 0 0  0  0  0 0 0 0 0 0 0 3 0 0 0 0 0 0 0 0 0 0 0 0  0  0  0 0 0 0 0 0 0 3 0 0 0 0 0 0 0 0 0 0 0 0  0  0  0 0 0 0 0 0 0 3 0 0 0 0 0 0 0 0 0 0 0 0  0  0  0 0 0 0 0 0 0 3 0 0 0 0 0 0 0 0 0 0 0 0  0  0  0 0 0 0 0 0 0 3 0 0 0 0 0 0 0 0 0 0 0 0  0  0  0 0 0 0 0 0 0 3 0 0 0 0 0 0 0 0 0 0 0 0  0  0  0 0 0 0 0 0 0 3 0 0 0 0 0 0 0 0 0 0 0
0  0  0  0 0 0 0 0 0 0 0 0 0 0 0 0 0 0 0 0 0 0 0  0  0  0 0 0 0 0 0 0 0 0 0 0 0 0 0 0 0 0 0 0 0  0  0  0 0 0 0 0 0 0 0 0 0 0 0 0 0 0 0 0 0 0 0  0  0  0 0 0 0 0 0 0 0 0 0 0 0 0 0 0 0 0 0 0 0  0  0  0 0 0 0 0 0 0 0 0 0 0 0 0 0 0 0 0 0 0 0  0  0  0 0 0 0 0 0 0 0 0 0 0 0 0 0 0 0 0 0 0 0  0  0  0 0 0 0 0 0 0 0 0 0 0 0 0 0 0 0 0 0 0 0  0  0  0 0 0 0 0 0 0 0 0 0 0 0 0 0 0 0 0 0 0 0  0  0  0 0 0 0 0 0 0 0 0 0 0 0 0 0 0 0 0 0 0 0  0  0  0 0 0 0 0 0 0 0 0 0 0 0 0 0 0 0 0 0 0 0  0  0  0 0 0 0 0 0 0 0 0 0 0 0 0 0 0 0 0 0 0 0  0  0  0 0 0 0 0 0 0 0 0 0 0 0 0 0 0 0 0 0 0 0  0  0  0 0 0 0 0 0 0 0 0 0 0 0 0 0 0 0 0 0 0 0  0  0  0 0 0 0 0 0 0 0 0 0 0 0 0 0 0 0 0 0 0 0  0  0  0 0 0 0 0 0 0 0 0 0 0 0 0 0 0 0 0 0 0 0  0  0  0 0 0 0 0 0 0 0 0 0 0 0 0 0 0 0 0 0 0 0  0  0  0 0 0 0 0 0 0 0 0 0 0 0 0 0 0 0 0 0 0 0  0  0  0 0 0 0 0 0 0 0 0 0 0 0 0 0 0 0 0 0 0 0  0  0  0 0 0 0 0 0 0 0 0 0 0 0 0 0 0 0 0 0 0 0  0  0  0 0 0 0 0 0 0 0 0 0 0 0 0 0 0 0 0 0 0
0  19 20 0 0 0 0 0 0 0 0 0 0 0 0 0 0 0 0 0 0 0 0  19 20 0 0 0 0 0 0 0 0 0 0 0 0 0 0 0 0 0 0 0 0  19 20 0 0 0 0 0 0 0 0 0 0 0 0 0 0 0 0 0 0 0 0  19 20 0 0 0 0 0 0 0 0 0 0 0 0 0 0 0 0 0 0 0 0  19 20 0 0 0 0 0 0 0 0 0 0 0 0 0 0 0 0 0 0 0 0  19 20 0 0 0 0 0 0 0 0 0 0 0 0 0 0 0 0 0 0 0 0  19 20 0 0 0 0 0 0 0 0 0 0 0 0 0 0 0 0 0 0 0 0  19 20 0 0 0 0 0 0 0 0 0 0 0 0 0 0 0 0 0 0 0 0  19 20 0 0 0 0 0 0 0 0 0 0 0 0 0 0 0 0 0 0 0 0  19 20 0 0 0 0 0 0 0 0 0 0 0 0 0 0 0 0 0 0 0 0  19 20 0 0 0 0 0 0 0 0 0 0 0 0 0 0 0 0 0 0 0 0  19 20 0 0 0 0 0 0 0 0 0 0 0 0 0 0 0 0 0 0 0 0  19 20 0 0 0 0 0 0 0 0 0 0 0 0 0 0 0 0 0 0 0 0  19 20 0 0 0 0 0 0 0 0 0 0 0 0 0 0 0 0 0 0 0 0  19 20 0 0 0 0 0 0 0 0 0 0 0 0 0 0 0 0 0 0 0 0  19 20 0 0 0 0 0 0 0 0 0 0 0 0 0 0 0 0 0 0 0 0  19 20 0 0 0 0 0 0 0 0 0 0 0 0 0 0 0 0 0 0 0 0  19 20 0 0 0 0 0 0 0 0 0 0 0 0 0 0 0 0 0 0 0 0  19 20 0 0 0 0 0 0 0 0 0 0 0 0 0 0 0 0 0 0 0 0  19 20 0 0 0 0 0 0 0 0 0 0 0 0 0 0 0 0 0 0 0
3  3  3  3 3 3 3 3 3 3 3 3 3 3 3 3 3 3 3 3 3 3 3  3  3  3 3 3 3 3 3 3 3 3 3 3 3 3 3 3 3 3 3 3 3  3  3  3 3 3 3 3 3 3 3 3 3 3 3 3 3 3 3 3 3 3 3  3  3  3 3 3 3 3 3 3 3 3 3 3 3 3 3 3 3 3 3 3 3  3  3  3 3 3 3 3 3 3 3 3 3 3 3 3 3 3 3 3 3 3 3  3  3  3 3 3 3 3 3 3 3 3 3 3 3 3 3 3 3 3 3 3 3  3  3  3 3 3 3 3 3 3 3 3 3 3 3 3 3 3 3 3 3 3 3  3  3  3 3 3 3 3 3 3 3 3 3 3 3 3 3 3 3 3 3 3 3  3  3  3 3 3 3 3 3 3 3 3 3 3 3 3 3 3 3 3 3 3 3  3  3  3 3 3 3 3 3 3 3 3 3 3 3 3 3 3 3 3 3 3 3  3  3  3 3 3 3 3 3 3 3 3 3 3 3 3 3 3 3 3 3 3 3  3  3  3 3 3 3 3 3 3 3 3 3 3 3 3 3 3 3 3 3 3 3  3  3  3 3 3 3 3 3 3 3 3 3 3 3 3 3 3 3 3 3 3 3  3  3  3 3 3 3 3 3 3 3 3 3 3 3 3 3 3 3 3 3 3 3  3  3  3 3 3 3 3 3 3 3 3 3 3 3 3 3 3 3 3 3 3 3  3  3  3 3 3 3 3 3 3 3 3 3 3 3 3 3 3 3 3 3 3 3  3  3  3 3 3 3 3 3 3 3 3 3 3 3 3 3 3 3 3 3 3 3  3  3  3 3 3 3 3 3 3 3 3 3 3 3 3 3 3 3 3 3 3 3  3  3  3 3 3 3 3 3 3 3 3 3 3 3 3 3 3 3 3 3 3 3  3  3  3 3 3 3 3 3 3 3 3 3 3 3 3 3 3 3 3 3 3
